WE ./textures/b.xpm
SO ./textures/a.xpm
EA ./textures/c.xpm
NO ./textures/d.xpm
C 255,255,255
F 220,11,25

11111111111111111111111111111111111111111
110001N00000001000111111111111111111
11110000000000000011111111111111
111100000000000000111111111111
11110000000000000011111111111111
1111111111111111111111111111111111