WE ./textures/b.xpm
SO ./textures/a.xpm
EA ./textures/d.xpm
NO ./textures/c.xpm

F 220,100,0
C 225,30,0

111111111111111111111111111111111
100000000011000000000000000000001
101100000111000000000000000000001
100100000000000000000000000000001
1111111110110000011100000000000E1
100000000011000001110111111111111
111101111111110111000000000000001
111111111111111111111111111111111
111111111111111111111111111111111
111101111111110111010100000000001
110000001101010111000000000000001
100000000000000011000000000000001
100000000000000011010100000000001
111111111111111111111111111111111