WE ./textures/b.xpm
SO ./textures/a.xpm
EA ./textures/c.xpm
NO ./textures/d.xpm
C 255,255,255
F 220,11,25

11111111111111111111111111111111111111111
110001N100000001000111111111111111111
1111111111111111111111111111111111
11111111111111111111111111111111
1111111111111111111111111111111111
1111111111111111111111111111111111