SO ../textures/a.xpm
WE ./textures/b.xpm
C 255,255,255
F 220,11,25
EA ./textures/c.xpm
NO ./textures/d.xpm

11111111111111111111111111111111111
110001N100000001000111111111111111111
11111111111111111111111111111111111
1111111111111111111111111111111111
1111111111111111111111111111111111
11111111111111111111111111111111111