
SO ./textures/a.xpm
C 255,255,255
WE ./textures/b.xpm
F 220,11, 255
EA ./textures/c.xpm

NO ./textures/d.xpm

11111111111111111111111111111111111
110001N100000001000111111111111111111
11111111111111111111111111111111111
1
          1
11111111111111111111111111111111111
11111111111111111111111111111111111
11111111111111111111111111111111111